1
5
2,2,15,15,10,10,10,-5
2,2,15,15,0,0,0,-5
-200,-100,400,20,39,37,37,-1
-95,10,15,15,255,0,127,-1
-200,-100,50,100,0,0,0,-1
170,-100,50,100,0,0,0,-1
1700,-100,50,100,0,0,0,-1
