1
7
2,2,15,15,255,0,127,-5
2,2,15,15,255,0,127,-5
-50,10,35,20,39,37,37,-1
50,0,30,30,39,37,37,-1
50,50,20,20,39,37,37,-1
-100,-10,20,20,39,37,37,-1
-10,-50,150,20,39,37,37,-1
20,-10,20,20,39,37,37,-1
-95,10,15,15,255,0,127,-1
