2
8
2,2,15,15,255,0,127,-5
60,2,14,30,255,102,0,-5
2,2,15,15,255,0,127,-5
60,2,14,30,255,102,0,-5
-100,20,35,20,102,10,62,0
10,40,30,30,39,37,37,-1
60,50,20,20,102,10,62,0
-40,-10,20,20,173,42,10,1
-10,-50,150,20,39,37,37,-1
30,-10,20,20,173,42,10,1
-95,40,15,15,255,0,127,-1
30,10,15,30,255,102,0,-1
