1
4
-10,-10,15,15,255,0,127,-5
-10,-10,15,15,255,0,127,-5
-120,-70,250,30,39,37,37,-1
30,5,35,10,39,37,37,-1
70,30,35,10,39,37,37,-1
90,40,15,15,255,0,127,-1
